Node	Candidate	Good	Codeword
GACC	True	True	False
TAC	False	False	False
TCTT	True	False	False
CACGT	False	False	False
GATTT	False	False	False
ATCGC	False	False	False
TCCGG	False	False	False
CGTGA	False	False	False
TATGT	False	False	False
AGAGG	False	False	False
ACTAA	False	False	False
AGCGC	False	False	False
TACCC	False	False	False
TTCGA	False	False	False
TTT	False	False	False
GGCGC	False	False	False
TCA	False	False	False
ATGGT	False	False	False
TAAAG	False	False	False
CTATT	False	False	False
AAGTG	False	False	False
TATA	True	False	False
ATCAA	False	False	False
TGTTT	False	False	False
CCGTA	False	False	False
TGGT	True	False	False
TGTCC	False	False	False
AAAAA	False	False	False
GTCCC	False	False	False
TTAC	True	True	False
GAGTT	False	False	False
CCATA	False	False	False
CATTG	False	False	False
TGACA	False	False	False
GTATA	False	False	False
TGGGC	False	False	False
ACGGA	False	False	False
AGG	False	False	False
CGTTC	False	False	False
CGACC	False	False	False
TAACC	False	False	False
TACGT	False	False	False
CGTCA	False	False	False
GCCAA	False	False	False
AACGC	False	False	False
CTGGC	False	False	False
GGGG	True	False	False
GCAGT	False	False	False
TTGA	True	True	False
GCGCA	False	False	False
AATC	True	True	False
GCC	False	False	False
GGCCG	False	False	False
TCTAG	False	False	False
TCAGA	False	False	False
CGTT	True	True	False
ACAGG	False	False	False
GAG	False	False	False
GTCG	True	True	False
GTTAT	False	False	False
GGG	False	False	False
GGAGA	False	False	False
ACCAG	False	False	False
TGGC	True	True	False
GCAAT	False	False	False
CACTT	False	False	False
GATGT	False	False	False
AGACT	False	False	False
GCCCG	False	False	False
AGAG	True	False	False
TGGGA	False	False	False
AGTTT	False	False	False
GGGTT	False	False	False
GCCG	True	False	False
ACCGT	False	False	False
TCCCT	False	False	False
TTCCA	False	False	False
TATTA	False	False	False
GGAGG	False	False	False
CATAT	False	False	False
TTAA	True	False	False
AGAGA	False	False	False
GCCAG	False	False	False
CCCTG	False	False	False
GCACC	False	False	False
TCGGC	False	False	False
CTGCG	False	False	False
CCGG	True	False	False
CGGTT	False	False	False
CCAAC	False	False	False
ATCT	True	True	False
GTTCA	False	False	False
ATACT	False	False	False
TGTAG	False	False	False
TTAGG	False	False	False
AATT	True	False	False
TGTG	True	False	False
CATCT	False	False	False
AGATT	False	False	False
TCTTA	False	False	False
GGCAT	False	False	False
AAAGA	False	False	False
CAGA	True	True	False
TAGCA	False	False	False
GACGG	False	False	False
ACATG	False	False	False
TTTA	True	False	False
TTATT	False	False	False
CTGTG	False	False	False
CCATG	False	False	False
CCCCA	False	False	False
CAC	False	False	False
CCAG	True	True	False
TTCT	True	False	False
TACCA	False	False	False
TAATA	False	False	False
GGGA	True	False	False
GTCGC	False	False	False
CTCAC	False	False	False
CACT	True	True	False
TGCG	True	True	False
CTAAA	False	False	False
CACCC	False	False	False
CAGGC	False	False	False
CGGGT	False	False	False
ATACC	False	False	False
CCAT	True	True	False
CCCG	True	False	False
GCGAC	False	False	False
GATCT	False	False	False
CAAC	True	False	False
CCA	False	False	False
GCTGG	False	False	False
TGCAA	False	False	False
AGCAA	False	False	False
CTGCC	False	False	False
TTTTG	False	False	False
CGTTG	False	False	False
AGTG	True	True	False
CTTCT	False	False	False
GGC	False	False	False
CAACT	False	False	False
GTAA	True	True	False
GAAT	True	True	False
CGTC	True	True	False
ACGAA	False	False	False
AACTC	False	False	False
TTTAG	False	False	False
GCCGT	False	False	False
GTTCC	False	False	False
TGCTC	False	False	False
ATTC	True	True	False
TCCTA	False	False	False
TCC	False	False	False
CTGTT	False	False	False
CTATA	False	False	False
TTGC	True	True	False
GCGAT	False	False	False
TACG	True	True	False
GAACG	False	False	False
GGCAC	False	False	False
ATCA	True	True	False
GAGAA	False	False	False
TCTTC	False	False	False
CTCAG	False	False	False
CGGG	True	False	False
GACAC	False	False	False
GCTGT	False	False	False
AAGAA	False	False	False
ATGCT	False	False	False
GTAAA	False	False	False
TATCG	False	False	False
GAATG	False	False	False
GCATT	False	False	False
AAAT	True	False	False
ATAGC	False	False	False
CGGTA	False	False	False
GATTA	False	False	False
ACCGG	False	False	False
AGGTA	False	False	False
CTAGC	False	False	False
TATCA	False	False	False
TCGAC	False	False	False
TCAGC	False	False	False
GTGCA	False	False	False
AGTT	True	True	False
GTAAT	False	False	False
ATGTA	False	False	False
GCTC	True	True	False
AGAGT	False	False	False
GATGA	False	False	False
AGTA	True	True	False
TTG	False	False	False
ACGGG	False	False	False
TGAGG	False	False	False
TGGCG	False	False	False
ATCGG	False	False	False
GCTCG	False	False	False
AAATT	False	False	False
TTCTG	False	False	False
TTCTT	False	False	False
ACGTT	False	False	False
AGCG	True	True	False
AACGA	False	False	False
GCACA	False	False	False
TCTGG	False	False	False
TGCGT	False	False	False
ATGGC	False	False	False
CCCA	True	False	False
CTCAA	False	False	False
GGTCC	False	False	False
GACTT	False	False	False
CCTCT	False	False	False
GGAGT	False	False	False
CGCTT	False	False	False
GTATG	False	False	False
TGC	False	False	False
GCTTC	False	False	False
CACAG	False	False	False
GATCC	False	False	False
TCCGC	False	False	False
CATCC	False	False	False
ATATA	False	False	False
ACTC	True	True	False
CAAGA	False	False	False
GCAG	True	True	False
GGAGC	False	False	False
ATTGT	False	False	False
GGTAT	False	False	False
AAGCT	False	False	False
ACACG	False	False	False
TTTGT	False	False	False
GACT	True	True	False
TGCTT	False	False	False
ATGAA	False	False	False
GGACC	False	False	False
TCAC	True	True	False
AACCC	False	False	False
CGGTG	False	False	False
TTATA	False	False	False
TAAA	True	False	False
CATGA	False	False	False
AACAT	False	False	False
CGTCC	False	False	False
TACGA	False	False	False
AAGC	True	True	False
GCAAC	False	False	False
CGCCT	False	False	False
TCCTT	False	False	False
GCGAG	False	False	False
AGCTT	False	False	False
CAGAG	False	False	False
TGAC	True	True	False
CAGTT	False	False	False
TATGA	False	False	False
ACTTA	False	False	False
TTATC	False	False	False
CGGCT	False	False	False
AGGAA	False	False	False
ACG	False	False	False
GAA	False	False	False
GAACT	False	False	False
TGTT	True	False	False
GGGTC	False	False	False
GACCT	False	False	False
TGATC	False	False	False
CGTAA	False	False	False
CCCTT	False	False	False
AGCA	True	True	False
CTGGT	False	False	False
CCCAA	False	False	False
AATCT	False	False	False
GGGAG	False	False	False
AGGGA	False	False	False
TCACG	False	False	False
AATTC	False	False	False
GACAG	False	False	False
AAGAG	False	False	False
ACCAC	False	False	False
TGGCA	False	False	False
CATGT	False	False	False
ACAAC	False	False	False
CCAAG	False	False	False
CCCGT	False	False	False
CCCGA	False	False	False
AGATC	False	False	False
GACCC	False	False	False
AAGCC	False	False	False
GTTC	True	True	False
AGAGC	False	False	False
TAACT	False	False	False
AGTCA	False	False	False
ATA	False	False	False
AGAAG	False	False	False
CCGTC	False	False	False
TGATG	False	False	False
CGAA	True	True	False
ACGTC	False	False	False
CCAGC	False	False	False
CAAA	True	False	False
GCTA	True	True	False
TTCC	True	False	False
TCTTT	False	False	False
TCG	False	False	False
CATC	True	True	False
TCATC	False	False	False
GCGTC	False	False	False
GCG	False	False	False
GGAA	True	False	False
CCGGG	False	False	False
CTGGA	False	False	False
TGCT	True	True	False
CCAGG	False	False	False
ATTTT	False	False	False
ACGG	True	True	False
GCA	False	False	False
TTCG	True	True	False
CATTC	False	False	False
GCCAC	False	False	False
GTTTA	False	False	False
CTCGA	False	False	False
TTAT	True	False	False
TCCCG	False	False	False
AAGA	True	False	False
TCCC	True	False	False
CCGAC	False	False	False
TCTAA	False	False	False
GAAAG	False	False	False
CAGTA	False	False	False
TAAG	True	True	False
CGC	False	False	False
CCTAA	False	False	False
ATGTC	False	False	False
ATAGG	False	False	False
CTTCG	False	False	False
CCCCT	False	False	False
AACC	True	False	False
CCTTC	False	False	False
TATCT	False	False	False
AATAT	False	False	False
AAAC	True	False	False
TTAG	True	True	False
TAAAA	False	False	False
AGA	False	False	False
GAATT	False	False	False
GTCTA	False	False	False
GTA	False	False	False
ATCGA	False	False	False
AAATA	False	False	False
GGAT	True	True	False
CTTAC	False	False	False
TGCAT	False	False	False
ACGTA	False	False	False
GCTTA	False	False	False
TGTA	True	True	False
CCTTT	False	False	False
TGCA	True	True	False
GCTAT	False	False	False
ACTG	True	True	False
GACTC	False	False	False
GTTAG	False	False	False
GCCT	True	True	False
GCCGC	False	False	False
TAGT	True	True	False
TCGT	True	True	False
GGAAG	False	False	False
GTTCT	False	False	False
GGCTG	False	False	False
GCGAA	False	False	False
GACGT	False	False	False
GCTT	True	True	False
TTA	False	False	False
CGATC	False	False	False
GTGCC	False	False	False
AACAG	False	False	False
GCAGG	False	False	False
TTAGC	False	False	False
CTTTA	False	False	False
GTAGT	False	False	False
CGGAG	False	False	False
TCGTG	False	False	False
AAACC	False	False	False
CCGGC	False	False	False
AGTTC	False	False	False
CCTAT	False	False	False
ACCA	True	False	False
ACAGT	False	False	False
ACCTG	False	False	False
TGATT	False	False	False
ACCAT	False	False	False
AGTCC	False	False	False
GAATA	False	False	False
TATAT	False	False	False
CTAA	True	True	False
CCCCG	False	False	False
ATCTA	False	False	False
GTAGG	False	False	False
GGCA	True	True	False
GAGAT	False	False	False
GTGTA	False	False	False
CGGTC	False	False	False
TGTTC	False	False	False
AACCG	False	False	False
ATGGA	False	False	False
GGTGA	False	False	False
CCTC	True	False	False
ATCCA	False	False	False
TGAT	True	True	False
GGTTA	False	False	False
GGTCG	False	False	False
AGCCG	False	False	False
GGAAT	False	False	False
ACGAG	False	False	False
ACCCG	False	False	False
TACA	True	True	False
GGCAA	False	False	False
AACT	True	True	False
CAGCC	False	False	False
AGTTG	False	False	False
AGGCG	False	False	False
TCCGT	False	False	False
CATG	True	True	False
CATGC	False	False	False
GGAC	True	True	False
TTCGG	False	False	False
AGGGC	False	False	False
CGCCA	False	False	False
AACTA	False	False	False
TCT	False	False	False
CCGA	True	True	False
GGTAA	False	False	False
GCGC	True	False	False
CGCTA	False	False	False
TTGAG	False	False	False
GAGAG	False	False	False
CACAA	False	False	False
TATTG	False	False	False
GGCTC	False	False	False
CCTGG	False	False	False
CATAG	False	False	False
CCAA	True	False	False
GAGAC	False	False	False
ACGCA	False	False	False
ATACG	False	False	False
GGTG	True	False	False
AGCAG	False	False	False
AGGCT	False	False	False
CTACG	False	False	False
CGCTG	False	False	False
GTCCG	False	False	False
TTCGT	False	False	False
GGCGT	False	False	False
TAACA	False	False	False
GACAT	False	False	False
CGAGC	False	False	False
ATAAA	False	False	False
ATGTG	False	False	False
TGTGC	False	False	False
TGGCC	False	False	False
GCATA	False	False	False
TAGAA	False	False	False
GGGAA	False	False	False
GCCCC	False	False	False
ATGCG	False	False	False
CAGGA	False	False	False
CTCAT	False	False	False
TACTA	False	False	False
CGCCC	False	False	False
GGAG	True	False	False
TACGC	False	False	False
ACGAC	False	False	False
CGAC	True	True	False
CGGAC	False	False	False
TCATG	False	False	False
GTTGG	False	False	False
ACGGT	False	False	False
CAT	False	False	False
CCGT	True	True	False
TGACC	False	False	False
CCCT	True	False	False
AAGG	True	False	False
GCCTC	False	False	False
CCTGA	False	False	False
TGGAG	False	False	False
GTGAG	False	False	False
AATCA	False	False	False
GAGGG	False	False	False
AGGA	True	False	False
CCCTA	False	False	False
TAACG	False	False	False
GGCCA	False	False	False
GCCTG	False	False	False
CTGCT	False	False	False
CAATA	False	False	False
CAAT	True	True	False
GAACC	False	False	False
CTCG	True	True	False
CTCTT	False	False	False
AAAGT	False	False	False
AGAT	True	True	False
CCGGA	False	False	False
CAGAC	False	False	False
TCACA	False	False	False
ATCCT	False	False	False
GTGTT	False	False	False
ATTAA	False	False	False
AGCC	True	True	False
ATTCG	False	False	False
AACGT	False	False	False
GGCTT	False	False	False
GGGCC	False	False	False
CACTG	False	False	False
TTCCT	False	False	False
ACATC	False	False	False
TCGGG	False	False	False
TCGGA	False	False	False
AAACT	False	False	False
AGTGG	False	False	False
GCGTT	False	False	False
AACG	True	True	False
GTTA	True	True	False
AAGGG	False	False	False
TTGCA	False	False	False
CCAAT	False	False	False
CACAT	False	False	False
GTACC	False	False	False
CCCTC	False	False	False
TAG	False	False	False
GTCT	True	True	False
ACAAT	False	False	False
TTACA	False	False	False
TACAG	False	False	False
ATATC	False	False	False
CAAG	True	True	False
GTGC	True	True	False
TCAAT	False	False	False
AAGT	True	True	False
CTCA	True	True	False
TGAAG	False	False	False
CTTCA	False	False	False
AGTGA	False	False	False
CTAAT	False	False	False
TTTG	True	False	False
TAGGA	False	False	False
TCTCA	False	False	False
GCCTA	False	False	False
AAA	False	False	False
GCAAG	False	False	False
AACCT	False	False	False
ATGAG	False	False	False
TGACT	False	False	False
AATAA	False	False	False
CATTA	False	False	False
CGAAT	False	False	False
GGTA	True	True	False
CACGG	False	False	False
CAGGT	False	False	False
ATTGA	False	False	False
TTTTT	False	False	False
GCCCT	False	False	False
TCTCT	False	False	False
CTAGG	False	False	False
AGTAA	False	False	False
AAAAC	False	False	False
GTAAC	False	False	False
AAAAG	False	False	False
GTGT	True	False	False
GGTTC	False	False	False
AGTAG	False	False	False
CACAC	False	False	False
TTTTA	False	False	False
CCGAG	False	False	False
ATATG	False	False	False
ATGCC	False	False	False
AAGCA	False	False	False
GAGT	True	True	False
CCCAT	False	False	False
TGTGG	False	False	False
GCGA	True	True	False
CGAT	True	True	False
GAGTC	False	False	False
CAAAC	False	False	False
AGACA	False	False	False
AGAAC	False	False	False
ACAG	True	True	False
GAAAC	False	False	False
ACTCC	False	False	False
CTACT	False	False	False
ACTGT	False	False	False
GAGGT	False	False	False
CATTT	False	False	False
TCGCA	False	False	False
ACCTC	False	False	False
CCCGG	False	False	False
TTTCG	False	False	False
CAATG	False	False	False
TTGCT	False	False	False
AAGGA	False	False	False
CCGCC	False	False	False
CTTTC	False	False	False
TTTTC	False	False	False
AGCGT	False	False	False
TAAC	True	True	False
GAGA	True	False	False
GGATG	False	False	False
GAAAA	False	False	False
CGGGG	False	False	False
TCGG	True	True	False
TTGAT	False	False	False
GGCC	True	False	False
AAGAC	False	False	False
CTGC	True	True	False
CCGCA	False	False	False
AGAA	True	False	False
AGGTT	False	False	False
TCAAG	False	False	False
TTCCG	False	False	False
CACGC	False	False	False
AGTAT	False	False	False
TAGCG	False	False	False
ACGCG	False	False	False
CCGC	True	False	False
CGGCA	False	False	False
GGACG	False	False	False
TAGCC	False	False	False
GTCGG	False	False	False
ACCGC	False	False	False
GACGA	False	False	False
TGGAC	False	False	False
CGTAG	False	False	False
CCGGT	False	False	False
ATTTC	False	False	False
CTTA	True	True	False
GTCC	True	True	False
GATG	True	True	False
CGCAT	False	False	False
ACTTT	False	False	False
TTGG	True	False	False
AATG	True	True	False
CTTAA	False	False	False
GAT	False	False	False
TGGCT	False	False	False
GATCG	False	False	False
CACTC	False	False	False
CGAAC	False	False	False
ACTTG	False	False	False
GAAGT	False	False	False
TCTA	True	True	False
GTTTT	False	False	False
CAGCG	False	False	False
GCTAC	False	False	False
CGCAC	False	False	False
GCTAA	False	False	False
ACTGC	False	False	False
CTCCC	False	False	False
TGT	False	False	False
ACGTG	False	False	False
GCAAA	False	False	False
TACAC	False	False	False
CGGT	True	True	False
CCAGA	False	False	False
GGGCT	False	False	False
GATAA	False	False	False
TCGA	True	True	False
TGCTG	False	False	False
TTTAT	False	False	False
TATG	True	True	False
CCTA	True	True	False
TGTC	True	True	False
GTG	False	False	False
AAGTT	False	False	False
GTACT	False	False	False
CTAAC	False	False	False
TCCAT	False	False	False
GGCCT	False	False	False
GACTG	False	False	False
GGA	False	False	False
ACC	False	False	False
TCGTA	False	False	False
CTCCA	False	False	False
AGCCC	False	False	False
CGTCT	False	False	False
GGTCA	False	False	False
TGCGG	False	False	False
GGATT	False	False	False
TGGTG	False	False	False
TCCAG	False	False	False
TCGC	True	True	False
GAGCG	False	False	False
ACAC	True	False	False
CAGG	True	True	False
CGATT	False	False	False
CCT	False	False	False
ATATT	False	False	False
AGC	False	False	False
CTTG	True	True	False
AAGGC	False	False	False
TTCGC	False	False	False
TAGTG	False	False	False
CTGAA	False	False	False
ATCG	True	True	False
TCAGT	False	False	False
GGGGT	False	False	False
CATA	True	True	False
TGAA	True	True	False
GAAA	True	False	False
ATCTT	False	False	False
ATTAT	False	False	False
TACT	True	True	False
CTCCT	False	False	False
ACAT	True	True	False
ACTAG	False	False	False
ATAT	True	False	False
CGACA	False	False	False
GGATC	False	False	False
CAGCA	False	False	False
AAAAT	False	False	False
CTGAT	False	False	False
AGAAT	False	False	False
CCTG	True	True	False
ATTCT	False	False	False
GAAGC	False	False	False
GTCAC	False	False	False
AGTGC	False	False	False
ATTT	True	False	False
ACATA	False	False	False
AAGTA	False	False	False
ATCGT	False	False	False
AACGG	False	False	False
TATGC	False	False	False
CCC	False	False	False
TAATT	False	False	False
TAAGT	False	False	False
ATAC	True	True	False
TGCTA	False	False	False
TTGGG	False	False	False
TGTCA	False	False	False
TGTGA	False	False	False
TAATC	False	False	False
TGCC	True	True	False
GAC	False	False	False
CTGTC	False	False	False
TCACC	False	False	False
GGCGA	False	False	False
ACTAC	False	False	False
TTAAC	False	False	False
ATCCG	False	False	False
GCACT	False	False	False
TTACG	False	False	False
ACCTT	False	False	False
CTGAG	False	False	False
TTAAA	False	False	False
TGACG	False	False	False
ATACA	False	False	False
CCACC	False	False	False
CGCC	True	False	False
ATGA	True	True	False
TCGAA	False	False	False
GTATT	False	False	False
ACCCA	False	False	False
GATT	True	True	False
CATGG	False	False	False
CTTC	True	False	False
GGGGG	False	False	False
TTTCC	False	False	False
CACC	True	False	False
TAGAG	False	False	False
TGTGT	False	False	False
GACTA	False	False	False
CGCT	True	True	False
AAAGC	False	False	False
TTCCC	False	False	False
AAAA	True	False	False
TCCGA	False	False	False
TAGG	True	True	False
ATGAC	False	False	False
GGTGT	False	False	False
GCGG	True	False	False
CGTTT	False	False	False
GTGA	True	True	False
AGCAT	False	False	False
TGAAT	False	False	False
CGCGA	False	False	False
CCCAG	False	False	False
CTCGC	False	False	False
GATCA	False	False	False
TTTAC	False	False	False
CATCA	False	False	False
CACA	True	False	False
TGCCA	False	False	False
CCTAG	False	False	False
CTCCG	False	False	False
GGTTG	False	False	False
CCTT	True	False	False
CTAT	True	True	False
TTTCT	False	False	False
CATT	True	True	False
TGCAG	False	False	False
TCAT	True	True	False
TATGG	False	False	False
GCATG	False	False	False
TTGGT	False	False	False
TAGAC	False	False	False
TAAGG	False	False	False
TCAAA	False	False	False
TACCG	False	False	False
CAATT	False	False	False
ACCAA	False	False	False
CTCTG	False	False	False
TGCGC	False	False	False
AACA	True	False	False
GAGTG	False	False	False
GGGT	True	False	False
AAGTC	False	False	False
CAGTG	False	False	False
CGGGA	False	False	False
GAGCT	False	False	False
AGCT	True	True	False
GGTGG	False	False	False
ACCT	True	True	False
AAT	False	False	False
TGAGC	False	False	False
TGAAC	False	False	False
CTTT	True	False	False
CGAGT	False	False	False
AATGG	False	False	False
ACACA	False	False	False
GATA	True	True	False
TCTAC	False	False	False
CCGTT	False	False	False
CGATA	False	False	False
CAAGC	False	False	False
TTC	False	False	False
CCTGT	False	False	False
CTGGG	False	False	False
GCAT	True	True	False
ATCC	True	True	False
TAAT	True	False	False
GAGG	True	False	False
AATTT	False	False	False
CAGGG	False	False	False
TGTCG	False	False	False
AATCC	False	False	False
AGTCG	False	False	False
GGGCG	False	False	False
TTCTA	False	False	False
CGAAG	False	False	False
ACTCG	False	False	False
GGCT	True	True	False
CGCGG	False	False	False
CGG	False	False	False
TAA	False	False	False
CACGA	False	False	False
ACACC	False	False	False
ACA	False	False	False
AGACG	False	False	False
ATAG	True	True	False
TATC	True	True	False
GCTGA	False	False	False
ATGG	True	True	False
CGACT	False	False	False
CTTAG	False	False	False
TAATG	False	False	False
CAGTC	False	False	False
ATC	False	False	False
CACG	True	True	False
ACTGA	False	False	False
GACCG	False	False	False
ATCTG	False	False	False
ACTGG	False	False	False
TTCAC	False	False	False
TACGG	False	False	False
AACTT	False	False	False
GTTTC	False	False	False
ACT	False	False	False
ATGC	True	True	False
GCGGC	False	False	False
AGGAG	False	False	False
GCCA	True	True	False
GAAC	True	True	False
TTAGT	False	False	False
TGGGT	False	False	False
CAAGT	False	False	False
CTCTC	False	False	False
TCGTC	False	False	False
CCTCC	False	False	False
CGTGC	False	False	False
GTAT	True	True	False
TACC	True	True	False
TCAGG	False	False	False
GTAG	True	True	False
GGGTG	False	False	False
TATAG	False	False	False
TAAAT	False	False	False
TTGTT	False	False	False
ATAAT	False	False	False
TTGCG	False	False	False
GCTCA	False	False	False
CTGAC	False	False	False
TCGCG	False	False	False
AGCTC	False	False	False
CATCG	False	False	False
TATAC	False	False	False
GCT	False	False	False
AGTC	True	True	False
CAG	False	False	False
GTATC	False	False	False
GGTCT	False	False	False
AGCAC	False	False	False
AATAC	False	False	False
CACCA	False	False	False
TTCAT	False	False	False
AGCCA	False	False	False
CCG	False	False	False
ATTTA	False	False	False
AATTA	False	False	False
TTGTA	False	False	False
TAGTT	False	False	False
ATTAG	False	False	False
AAAGG	False	False	False
CAAAA	False	False	False
CCACG	False	False	False
GTGG	True	False	False
ACGC	True	True	False
TCTGA	False	False	False
CTAGT	False	False	False
CCGAA	False	False	False
GGGGC	False	False	False
ACGA	True	True	False
AAATG	False	False	False
ACACT	False	False	False
TGAGA	False	False	False
GCTTG	False	False	False
GGAAA	False	False	False
AAG	False	False	False
GCGCT	False	False	False
GAAGG	False	False	False
GGACA	False	False	False
CTCTA	False	False	False
CAGC	True	True	False
CTAC	True	True	False
CCACT	False	False	False
GTT	False	False	False
AGCTA	False	False	False
CTCGG	False	False	False
TCAG	True	True	False
CGGCG	False	False	False
TTGAA	False	False	False
ACGGC	False	False	False
CTACA	False	False	False
ACAAG	False	False	False
TCGAT	False	False	False
AGAAA	False	False	False
AGGT	True	True	False
TCCCC	False	False	False
TTGTG	False	False	False
GATAG	False	False	False
CGAGA	False	False	False
GGCG	True	False	False
ACTT	True	True	False
GTCAA	False	False	False
ACGAT	False	False	False
AGATA	False	False	False
TGTTG	False	False	False
GCGCC	False	False	False
CGGAT	False	False	False
GCATC	False	False	False
CGCGT	False	False	False
CGGAA	False	False	False
AATGA	False	False	False
CGTTA	False	False	False
TCTC	True	False	False
TTTGC	False	False	False
ACAGA	False	False	False
ATAA	True	False	False
CCAAA	False	False	False
TGCAC	False	False	False
CCTTA	False	False	False
AGTGT	False	False	False
GTTTG	False	False	False
TCTAT	False	False	False
CTTTG	False	False	False
CTC	False	False	False
GAGGA	False	False	False
ACAGC	False	False	False
GGGTA	False	False	False
AAACA	False	False	False
TTTC	True	False	False
GGTTT	False	False	False
GTTT	True	False	False
GCAGA	False	False	False
CTCGT	False	False	False
GCTCC	False	False	False
CGGC	True	False	False
GTGAT	False	False	False
AATCG	False	False	False
CTATC	False	False	False
TTGCC	False	False	False
GTACG	False	False	False
GACG	True	True	False
ACGT	True	True	False
TTTT	True	False	False
TGAG	True	True	False
GACCA	False	False	False
GGAAC	False	False	False
CGCAA	False	False	False
TCCG	True	True	False
AGGG	True	False	False
CAAGG	False	False	False
GAAG	True	False	False
ACCCC	False	False	False
GGT	False	False	False
GTAC	True	True	False
TTCAA	False	False	False
TAAGA	False	False	False
GGCCC	False	False	False
AAACG	False	False	False
GGCTA	False	False	False
GAAGA	False	False	False
TTACC	False	False	False
GAGC	True	True	False
GTGGG	False	False	False
TCGCT	False	False	False
ACCCT	False	False	False
TTCTC	False	False	False
GATGG	False	False	False
GCCAT	False	False	False
GCTTT	False	False	False
TGAAA	False	False	False
CTTAT	False	False	False
CGATG	False	False	False
GTAGA	False	False	False
GCCC	True	False	False
TACTG	False	False	False
ATTGC	False	False	False
TCGTT	False	False	False
TTAAG	False	False	False
AATAG	False	False	False
TTTGG	False	False	False
AGGCC	False	False	False
TCTTG	False	False	False
CGTGT	False	False	False
GTTAA	False	False	False
TCCTC	False	False	False
TGCCT	False	False	False
CACCG	False	False	False
CTA	False	False	False
GTAAG	False	False	False
GCACG	False	False	False
AAGAT	False	False	False
ATTG	True	True	False
TTGGC	False	False	False
GCGGT	False	False	False
CGGA	True	True	False
CTAG	True	True	False
GAGCC	False	False	False
CGTG	True	True	False
ACAA	True	False	False
GGCAG	False	False	False
CGAAA	False	False	False
CCCC	True	False	False
CTAGA	False	False	False
TCATA	False	False	False
TCACT	False	False	False
ACTAT	False	False	False
GAAAT	False	False	False
GCAGC	False	False	False
GTCGA	False	False	False
CCTAC	False	False	False
TTGTC	False	False	False
GCCCA	False	False	False
ATGTT	False	False	False
AATGC	False	False	False
CCATC	False	False	False
TGGGG	False	False	False
ATG	False	False	False
TCTCC	False	False	False
TCCA	True	True	False
GTGGA	False	False	False
GAGTA	False	False	False
CACCT	False	False	False
AGT	False	False	False
ATCCC	False	False	False
AGGAC	False	False	False
CCGTG	False	False	False
TCGCC	False	False	False
GTCGT	False	False	False
ATCTC	False	False	False
GAACA	False	False	False
TAT	False	False	False
CAACG	False	False	False
CAATC	False	False	False
ATTCC	False	False	False
CTTGC	False	False	False
AGTTA	False	False	False
ATGAT	False	False	False
ACCGA	False	False	False
AACCA	False	False	False
CTGA	True	True	False
AGGTC	False	False	False
CTTGT	False	False	False
GGGGA	False	False	False
TAGTA	False	False	False
GTCCA	False	False	False
TCGGT	False	False	False
GTGGT	False	False	False
AATA	True	False	False
ACGCC	False	False	False
TACTT	False	False	False
ACTCA	False	False	False
TGCCC	False	False	False
TAGGT	False	False	False
TCAAC	False	False	False
AACTG	False	False	False
TATTC	False	False	False
GTCTC	False	False	False
ATT	False	False	False
GTGGC	False	False	False
ATTA	True	False	False
ACTTC	False	False	False
GGTGC	False	False	False
ACATT	False	False	False
TGGA	True	True	False
CTAAG	False	False	False
TTGGA	False	False	False
TATTT	False	False	False
GATAC	False	False	False
TGGTT	False	False	False
GATAT	False	False	False
ATTAC	False	False	False
TGGAA	False	False	False
TGATA	False	False	False
CAGCT	False	False	False
TGA	False	False	False
ATAGT	False	False	False
GCGGA	False	False	False
TTCA	True	True	False
GTC	False	False	False
TTAGA	False	False	False
TAGTC	False	False	False
ATAAG	False	False	False
CAA	False	False	False
CGTCG	False	False	False
TCAA	True	True	False
GTGAC	False	False	False
ATTCA	False	False	False
AAGCG	False	False	False
ATCAT	False	False	False
GTCAG	False	False	False
CAAAG	False	False	False
GGGAT	False	False	False
GATC	True	True	False
AGTAC	False	False	False
ATCAG	False	False	False
GCGCG	False	False	False
TTATG	False	False	False
AGACC	False	False	False
ACAAA	False	False	False
GATTG	False	False	False
TAAGC	False	False	False
CCAGT	False	False	False
CCTCA	False	False	False
ATTGG	False	False	False
TGGTC	False	False	False
CTACC	False	False	False
TAGCT	False	False	False
TAGGC	False	False	False
CGGGC	False	False	False
GTCTG	False	False	False
ACTA	True	True	False
TAAAC	False	False	False
CCGAT	False	False	False
CTTTT	False	False	False
TTCAG	False	False	False
CCGCT	False	False	False
CAAAT	False	False	False
ATGGG	False	False	False
GTGTC	False	False	False
GCAC	True	True	False
TGGTA	False	False	False
AAATC	False	False	False
CATAA	False	False	False
GTGCG	False	False	False
AGAC	True	True	False
GCGTA	False	False	False
GATGC	False	False	False
TCTCG	False	False	False
CGCAG	False	False	False
TTGAC	False	False	False
TCCAA	False	False	False
GTCA	True	True	False
TCATT	False	False	False
CTGTA	False	False	False
TAGC	True	True	False
ATGT	True	True	False
TGCCG	False	False	False
CGTAC	False	False	False
TAGA	True	True	False
GCTAG	False	False	False
CCTGC	False	False	False
CCATT	False	False	False
CAACC	False	False	False
CTT	False	False	False
CGCGC	False	False	False
CCACA	False	False	False
CGTGG	False	False	False
ATTTG	False	False	False
GAGCA	False	False	False
ACCC	True	False	False
GCGT	True	True	False
GGTAG	False	False	False
ACCTA	False	False	False
CGCA	True	True	False
CCCAC	False	False	False
TCCT	True	False	False
TGGAT	False	False	False
TACAA	False	False	False
TATCC	False	False	False
CGAG	True	True	False
TAGAT	False	False	False
TCTGC	False	False	False
GATTC	False	False	False
GTTG	True	False	False
ACCG	True	True	False
CCTCG	False	False	False
GTAGC	False	False	False
TTTCA	False	False	False
AGCCT	False	False	False
GGATA	False	False	False
TCCCA	False	False	False
GCCGA	False	False	False
CCCCC	False	False	False
GTTGC	False	False	False
CTGG	True	True	False
GCTG	True	True	False
ACGCT	False	False	False
TTTGA	False	False	False
CTCC	True	False	False
CGGCC	False	False	False
GTGTG	False	False	False
GCCTT	False	False	False
GGTT	True	False	False
AGGCA	False	False	False
GTGAA	False	False	False
GTACA	False	False	False
CTCT	True	False	False
CTTCC	False	False	False
GACAA	False	False	False
AGTCT	False	False	False
TGTCT	False	False	False
CAGT	True	True	False
GTCTT	False	False	False
GTCAT	False	False	False
TACCT	False	False	False
GTCCT	False	False	False
AGGGT	False	False	False
CCAC	True	False	False
TGTTA	False	False	False
CCGCG	False	False	False
CGACG	False	False	False
AATTG	False	False	False
GAGGC	False	False	False
GAATC	False	False	False
GGTC	True	True	False
CAACA	False	False	False
TCGAG	False	False	False
TACTC	False	False	False
CGAGG	False	False	False
CTTGA	False	False	False
TCTGT	False	False	False
CTG	False	False	False
AGATG	False	False	False
CACTA	False	False	False
CTGT	True	True	False
AACAA	False	False	False
TGAGT	False	False	False
TACAT	False	False	False
GACA	True	True	False
TTACT	False	False	False
TTAAT	False	False	False
TTGT	True	False	False
CTGCA	False	False	False
CTATG	False	False	False
CAGAA	False	False	False
CGCCG	False	False	False
CGA	False	False	False
TGTAA	False	False	False
CGT	False	False	False
CGTA	True	True	False
GCTCT	False	False	False
GCGTG	False	False	False
GGACT	False	False	False
TGCGA	False	False	False
GCCGG	False	False	False
TATT	True	False	False
ACTCT	False	False	False
TGG	False	False	False
AGGGG	False	False	False
ATCAC	False	False	False
TGTAC	False	False	False
CCCGC	False	False	False
ATAGA	False	False	False
TATAA	False	False	False
AATGT	False	False	False
AAC	False	False	False
TTTAA	False	False	False
CAGAT	False	False	False
GTTCG	False	False	False
AGCGA	False	False	False
TGTAT	False	False	False
ATGCA	False	False	False
AGGTG	False	False	False
AACAC	False	False	False
CGTAT	False	False	False
GTTGA	False	False	False
AAAG	True	False	False
GGGC	True	False	False
GTTGT	False	False	False
AGCGG	False	False	False
GTTAC	False	False	False
TCCTG	False	False	False
GGGAC	False	False	False
AAGGT	False	False	False
CATAC	False	False	False
GGGCA	False	False	False
GCTGC	False	False	False
GACGC	False	False	False
TCCAC	False	False	False
TAGGG	False	False	False
CTTGG	False	False	False
AGGC	True	True	False
CCTTG	False	False	False
TGGG	True	False	False
AGGAT	False	False	False
CGCTC	False	False	False
GCGGG	False	False	False
ATAAC	False	False	False
GGTAC	False	False	False
GCAA	True	True	False
TCTG	True	True	False
CGCG	True	False	False
AGCTG	False	False	False
GTGCT	False	False	False
GGCGG	False	False	False
